cmap 	character to glyph mapping
glyf 	glyph data
head 	font header
hhea 	horizontal header
hmtx 	horizontal metrics
loca 	index to location
maxp 	maximum profile
name 	naming
post 	PostScript
cvt  	control value
fpgm 	font program
hdmx 	horizontal device metrics
kern 	kerning
OS/2 	OS/2
prep 	control value program
acnt	accent attachment
ankr	anchor point
avar	axis variation
bdat	bitmap data
bhed	bitmap font header
bloc	bitmap location
bsln	baseline
cmap	character code mapping
cvar	CVT variation
cvt 	control value
EBSC	embedded bitmap scaling control
fdsc	font descriptor
feat	layout feature
fmtx	font metrics
fond	font family compatibility
fpgm	font program
fvar	font variation
gasp	grid-fitting and scan-conversion procedure
glyf	glyph outline
gvar	glyph variation
hdmx	horizontal device metrics
head	font header
hhea	horizontal header
hmtx	horizontal metrics
just	justification
kern	kerning
kerx	extended kerning
lcar	ligature caret
loca	glyph location
ltag	language tag
maxp	maximum profile
meta	metadata
mort	metamorphosis (deprecated)
morx	extended metamorphosis
name	name
opbd	optical bounds
OS/2	compatibility
post	glyph name and PostScript compatibility
prep	control value program
prop	properties
sbix	extended bitmaps
trak	tracking
vhea	vertical header
vmtx	vertical metrics
xref	cross-reference
Zapf	glyph reference 

      
